11111111
10E00001
10000001
10C000P1
10000001
11111111